0000000000000000000000000000000000000000
0000000000000000000000000000000000000000
0000000000000000000000000000000000000000
0000000000000000000000000000000000000000
0000000000000000000000000000000000000000
0000000000000000000000000000000000000000
0000000000000000000000000000000000000000
0000000000000000000000000000000000000000
0000000000000000000000000000000000000000
0000000000000000000000000000000000000000
0000000000000011110000000000000000000000
0000000000001110011000000000000000000000
0000000000011003001111110000000000000000
0000000000010000011000010000000000000000
0000000000100001100000021000000000000000
0000000001100011000000000100000000000000
0000000001000110000000000100000000000000
0000000011000100000000000110000000000000
0000000010002100001110000010000000000000
0000000010001100000012000010000000000000
0000000010001000550011000010000000000000
0000000010001000550001000010000000000000
0000000011001120000010000010000000000000
0000000001000111001110000110000000000000
0000000001000002111000000100000000000000
0000000001100000000000001100000000000000
0000000000110000000000011000000000000000
0000000000011100000002110000000000000000
0000000000000111000011100000000000000000
0000000000000001111110000000000000000000
0000000000000000000000000000000000000000
0000000000000000000000000000000000000000
0000000000000000000000000000000000000000
0000000000000000000000000000000000000000
0000000000000000000000000000000000000000
0000000000000000000000000000000000000000
0000000000000000000000000000000000000000
0000000000000000000000000000000000000000
0000000000000000000000000000000000000000
0000000000000000000000000000000000000000
