0000000000000000000000000000000000000000
0000000000000000000000000000000000000000
0000000000000000000000000000000000000000
0000000000000000000000000000000000000000
0000000000000000000000000000000111110000
0000000000000000000000000000000122210000
0000000000000000000000000000000105010000
0000000000000000000000000000000100010000
0000000000000000000000000000000100010000
0000000000000000000000000000000100010000
0000000000000000000000000000000100010000
0000000000000000000000000000000110010000
0000000000000000000000000000000120010000
0000000000000000000000000000000100010000
0000000000000000000000000000000100010000
0000000000000000000000000000000100010000
0000000000000000000000000000000100010000
0000000000000000000000000000000100010000
0000000000000000000000000000000100110000
0000000000000000000000000000000100210000
0000000000000000000000000000000100010000
0000000000000000000000000000000100010000
0000000000000000000000000000000100010000
0000000000000000000000000000000100010000
0000000000000000000000000000000100010000
0000111111111111111111111111111110010000
0000100000200000100000200000100000010000
0000100000000000100000000000100000010000
0000100000000000100000000000100000010000
0000100000000000100000000000100000010000
0000100000100000100000100000100200010000
0000100000100000000000100000000000010000
0000100000100000000000100000000000010000
0000100300100000000000100000000000010000
0000100000100000200000100000200000010000
0000111111111111111111111111111111110000
0000000000000000000000000000000000000000
0000000000000000000000000000000000000000
0000000000000000000000000000000000000000
0000000000000000000000000000000000000000
