0000000000000000000000000000000000000000
0000000000000000000000000000000000000000
0011111111111111111111111111111111111100
0010001200000000000211111111111111111100
0010401055400000000012000000000000002100
0010001055400000000010000000000000000100
0010401200000000000010000000000000000100
0010001111111111100010000000000000000100
0010000000002120000010000111111110000100
0010000000000100000010000002040210000100
0010000000002100000010000000000010000100
0010001200111100000010000000000010000100
0010001000120000000010000000000010000100
0010001000100000021111111110000010000100
0010001000100001111000000010000012000100
0010001404100001000000000010000011000100
0010021111100001000000000010000001000100
0010000002100001000000021111110001000100
0010000000100001000000000000000001002100
0012000000100001000000000000000001000100
0011110000100001000001000000000001000100
0010010000100001030021000000000021000100
0010010000100001000001111111111111000100
0010010000000001111111000000000000000100
0010012000000000000021400000000000000100
0010011100000000000001112000000000000100
0010000000004000000001000000000000000100
0010000000000000000001000000000000002100
0010000000000000000001000002111111111100
0010002111111111000001000000000000000100
0010000000210001000001000000000000000100
0010000000010401000001200000000000000100
0010000000010001000001111112000000000100
0010000000020401200000000000000000000100
0010000000000001000000000000000000002100
0010000000000001400000000000000111111100
0012000000000021000000000000002111111100
0011111111111111111111111111111111111100
0000000000000000000000000000000000000000
0000000000000000000000000000000000000000
