0000000000000000000000000000000000000000
0000000000000000001110000000000000000000
0000000000000000111011100000000000000000
0000000000000001120000110000000011111100
0000011110000001000000010000000010000110
0001110021000001000000001000000110000010
0001000001000001000000001000000120000010
0001000001000011000000002100001100030010
0011055001000012000000000100001000000010
0010055001000010000020000100001000000010
0010000001000010000010001100011000000010
0010011001000010000110001100011000000010
0010112001000010001100001100011000000110
0011100011000110001100011100011200000100
0011200010000120011100010100011100000100
0011000010000100110100100100010110000100
0012000010000100000100201100010010000100
0010000100000100000100001000010020002100
0010000100000100000100001000010000001100
0010000100001000000100011000110000001000
0010001000001000001120010000100000001000
0010001000001000001000010000100000011000
0110001000001000001000010001120000010000
0120001000011000011000111011000000010000
0100101000010000010000101110000000210000
0100101000110000010000100000000000110000
0100011000112000010000110000000001100000
0100211111111000010000012000011111100000
0100000020021100010000011000000021100000
0120000000000000012000021100000001000000
0100000000000000111000000020000011000000
0100000000000002101000000000000110000000
0100000000000001101000000000001100000000
0110000100000021001100000000001000000000
0010000112000011000111200000001000000000
0011000011111110000001110000210000000000
0001100000111100000000011111110000000000
0000111110011000000000000000000000000000
0000000011110000000000000000000000000000
0000000000000000000000000000000000000000
