0000000000000000000000000000000000000000
0000000000000000000000000000000000000000
0000000000000000000000000000000000000000
0000000000000000000001111111110000000000
0000000000111111111111000000210000000000
0000000000000100002000000000010000000000
0000000011111100000000000000011111111000
0000000000000100000000000000012000021000
0000000001111100000002000000010005501000
0000000000000100001111111120010005501000
0000001111111100001002000000010000001000
0000000000100200001000000000010021111000
0000011111100000001000000000010000001000
0000000000100000021000001000010000001000
0001111111100000001000001000010000001000
0000001000100000001000001000010000001000
0000011000000000001000001000010000001000
0000001000000021111002111111111112001000
0000111000000000021000000000212000001000
0000001000000000021000000000010000001000
0000011000000000021000000000010000001000
0000001021111111111000001000010000001000
0000001000101010101222221000010000001000
0000001000101010101111111000020000001000
0000001000101010101010101000000000001000
0000001000101010101010101000000020001000
0000011120101010101010101111111111111000
0000010000101010101010101000101010101000
0000010000101010101010101030101010101000
0000010000111111111111111000101010101000
0000010000002000001000001000101010101000
0000010000000000001000001020101010101000
0000010000000000002000001000101010101000
0000010000000000000000001000101010001000
0000012000001000000000000000100010000000
0000011111111002000002000000100000000000
0000000000001111111111111111100000000000
0000000000000000000000000000000000000000
0000000000000000000000000000000000000000
0000000000000000000000000000000000000000
