0000000000000000000000000000000000000000
0001111111111111111111111010100000101010
0001200000000212000002001111111111111110
0001000000000010000000001200000202020210
0001000000200020002000001000000000000010
0001000000100000001000001000000000000010
0001000111111111111000001000000000000010
0001000021010101010002001000000000000010
0001200001110101010000002000002020202010
0001000001010111010000000000001111100010
0001000001011101010000000000001000100010
0001000001010101110000000000001030100010
0001000201010101012000002000001000100010
0001000001111111111111111111111000100010
0001100001200000000000012000002000100010
0001000001200000000000012000000000100010
0001110001200000111200012000000000100010
0001000001112000120000011120000000121010
0001111000000000120000000000001000110010
0001001200000000120000000000021000100010
0001111111111111111111111111111111100010
0001001200000000002000001000021200000010
0001111000000000000000001000001000000010
0001001000000000000000021001001000001210
0001111000002000000000001001001000000110
0001001000011111111120001001001000000010
0001111000012222210000001001001000000010
0000001000012555210000001001001000000010
0001111000212555210000001001201001111110
0000001000012555210000001201001001010100
0001111000012000212000001001001001111110
0000001000010000010000001001001001010100
0000111000010000010000021001001001110100
0000001200010000010000001001000001010000
0001111000020000010000001001000021010000
0000001000000000210001111001111111000000
0000111111111111112000000001000000000000
0000000000000000010000000021000000000000
0000000000000000011111111111000000000000
0000000000000000000000000000000000000000
